%%%%%%%%%%%%%%%%%%%%%%%%%%%%%%%%%%%%
%                                 S%
% %%%%%%%%%%%%%%%%%%%%%%%%% %%%%%% %
%                           %%     %
% %%%%%%%%%%%%%%%%%%%%%%%%% %% %%%%%
%                           %%     %
% %%%%%%%%%%%%%%%%%%%%%%%%% %%%%%% %
%                           %      %
% %%%%%%%%%%%%%%%%%%%%%%%%% %% %%%%%
%                           %%     %
% %%%%%%%%%%%%%%%%%%%%%%%%% %%%%%% %
%                           %      %
% %%%%%%%%%%%%%%%%%%%%%%%%%%%% %%%%%
%                           %%     %
%       %%%%%%%%%%%%%%%%%%% %%  %% %
%%%%%%%%       %%    %%     %%%%%% %
%G          %%    %%    %%         %
%%%%%%%%%%%%%%%%%%%%%%%%%%%%%%%%%%%%