%%%%%%%%%%%%%%%%%%%%%%%%%%%%%%%%%%%%
%                                 S%
% %%%%%%%%%%%%%%%%%%%%%%% %%%%%%%% %
% %%   %   %      %%%%%%%   %%     %
% %% % % % % %%%% %%%%%%%%% %% %%%%%
% %% % % % %             %% %%     %
% %% % % % % % %%%%  %%%    %%%%%% %
% %  % % %   %    %% %%%%%% %      %
% %% % % %%%%%%%% %%        %% %%%%%
% %% % % %%       %%%%%%%%% %%     %
%    % %%%% %%%%%%%      %% %%%%%% %
%%%%%% %    %       %%%% %% %      %
%      %%%%%% %%%%% %       %% %%%%%
% %%%%%%      %       %%%%% %%     %
% %      %%%%%% %%%%%%%%%%% %%  %% %
% %%%%%%%%      %           %%%%%% %
%G        %%%%%%%%%%%%%%%%%        %
%%%%%%%%%%%%%%%%%%%%%%%%%%%%%%%%%%%%