%%%%%%%%%%%%%%%%%%%%%%%%%%%%%%%%%%%%
%                                 S%
% %%%%%%%%%%%%%%%%%%%%%%%%% %%%%%%%%
%                         % %%     %
%%%%%%%%%%%%%%%%%%%%%%%%% % %% %%%%%
%                         % %%     %
% %%%%%%%%%%%%%%%%%%%%%%%%% %%%%%% %
%                         % %      %
%%%%%%%%%%%%%%%%%%%%%%%%% % %% %%%%%
%                         % %%     %
% %%%%%%%%%%%%%%%%%%%%%%%%% %%%%%% %
%                         % %      %
%%%%%%%%%%%%%%%%%%%%%%%%% % %% %%%%%
%                         % %%     %
%        %%%%%%%%%%%%%%%%%% %%  %% %
%%%%%%%%%%                  %%%%%% %
%G         %%%%%%%%%%%%%%%%%       %
%%%%%%%%%%%%%%%%%%%%%%%%%%%%%%%%%%%%