%%%%%%%%%%%%%%%%%%%%%%%%%%%%%%%%%%%%
%                                 S%
% %%%%%%%%%%%%%%%%%%%%%%%%%%%%%%%% %
% %                         %%     %
% %%%%%%%%%%%%%%%%%%%%%%%   %% %%%%%
% %                         %%     %
% %%%%%%%%%%%%%%%%%%%%%%%%% %%%%%% %
% %                         %      %
% %%%%%%%%%%%%%%%%%%%%%%%   %% %%%%%
% %                         %%     %
% %%%%%%%%%%%%%%%%%%%%%%%%% %%%%%% %
% %                         %      %
% %%%%%%%%%%%%%%%%%%%%%%%   %% %%%%%
%       %                   %%     %
%       %%%%%%%%%%%%%%%%%%% %%  %% %
% %%%%%%  %%    %%    %%    %%%%%% %
%G        %  %%    %%    %%        %
%%%%%%%%%%%%%%%%%%%%%%%%%%%%%%%%%%%%