%%%%%%%%%%%%%%%%%%%%
%.           ...S .%
%.%%.%%.%%.%%.%% %.%
% %% %.....      %.%
%%%%%%%%%%%%%%%%%%%%