%%%%%%%%%%%
%   ...S .%
%.%%.%% %.%
%.      %.%
%%%%%%%%%%%