%%%%%%%%%%%%%%%%%%%%%%
%S                   %
%                    %
%                    %
%                    %
%                   G%
%%%%%%%%%%%%%%%%%%%%%%